                        
                        
   #                    
   ##          #        
  ####     #   ###      
############# #######   
#############  ######## 
#############       ####
########################